TTTTTTTTTTTTTTTTTTTTT
T O      R          T
T        RRRR      PT
TP          P       T
T       T          RT
T  RR       R       T
T    R  P           T
T    R              T
T                   T
TTTTTTTTTTTTTTTTTTTTT